25 11
########################
#     @ /  @           #
#     @    @           #
#     @@@@@@    !      #
#     !@!     @!       #
#                      #
#             @        #
#                      #
#    @@         @      #
#                      #
#####D##################