25 11
########################
#     @ /  @     T     #
#     @    @  H        #
#     @@@@@@    !      #
#     !@!     @!       #
#                   H  #
#  T        L @        #
#                      #
#    @@     F   @      #
#                      #
#####D##################