25 15
########################
#/    #               !#
#     #     #####   @  #
#     #  ####   #      #
#     #  #      #      #
#  T  ####     @#      #
#           H   #      #
#     @         #  !   #
#   L      #######     #
#######      H       T #
#        F      @      D 
#   @   ##      @ #    #
#       #    @ #       #
#       #       #     !#
########################