25 15
########################
#/    #      F        !#
#  F  #     #####   @  #
#     #  ####   #      #
#     #  #      #      #
#  T  ####     @#    T #
#      L    H   #      #
#     @         #  !   #
#   L      #######     #
#######      H       T #
#        F      @      D 
#   @   ##      @ #    #
#       #    @ #       #
#       #       #     !#
########################