24 15
#############D##########
#     #      !         #
#     #     #####   @  #
#     #         #      #
#     #  #   F  #   !  #
#  /  ####     @#      #
#          L    #    L #
#     @         #      #
#         #######   H  #
#######                #
#         F      H @   #
#   @   #      @ #     #
#       #   @ #        #
#   T   #        #    !#
########################