37 11
####################################
#                                  #
#            @                     #
#               !                  #
#     !@!                @!        #
#                                  #
#             @                    #
#      /                           #
#    @@                  @         #
#                                  #
#####D##############################