24 15
#############D##########
#     #               !#
#     #     #####   @  #
#     #  ####   #      #
#     #  #      #      #
#  /  ####     @#      #
#               #      #
#     @         #  !   #
#         #######      #
#######                #
#              @       #
#   @   ##      @ #    #
#       #    @ #       #
#       #       #     !#
########################