25 15
########################
#/    #               !#
#  F  #     #####   @  #
#     #  ####   #      #
#     #  #      #      #
#  T  ####     @#      #
#  L        H   #      #
#     @         #  !   #
#   L      #######     #
#######      H       T #
#        F      @      D 
#   @   ##      @ #    #
#       #    @ #       #
#       #       #     !#
########################