25 15
########################
#/    #               !#
#     #     #####   @  #
#     #  ####   #      #
#     #  #      #      #
#     ####     @#      #
#               #      #
#     @         #  !   #
#         #######      #
#######                #
#              @       D 
#   @   ##      @ #    #
#       #    @ #       #
#       #       #     !#
########################